//MAP CONVERTED BY dmm2tgm.py THIS HEADER COMMENT PREVENTS RECONVERSION, DO NOT REMOVE
"a" = (
/turf/closed/wall/mineral/decostone/moss/blue,
/area/rogue/under/xylix)
"c" = (
/obj/structure/trap/wall_projectile/hidden{
	dir = 8
	},
/obj/structure/fluff/walldeco/vinez/blue,
/turf/open/floor/concrete,
/area/rogue/under/xylix)
"d" = (
/turf/open/floor/cobblemoss,
/area/rogue/under/xylix)
"f" = (
/obj/structure/fluff/walldeco/xylixhint,
/obj/structure/fluff/walldeco/vinez/blue,
/turf/open/floor/concrete,
/area/rogue/under/xylix)
"l" = (
/turf/closed/wall/mineral/decostone/moss/blue/end{
	dir = 8
	},
/area/rogue/under/xylix)
"p" = (
/turf/closed/wall/mineral/decostone/moss/blue/end,
/area/rogue/under/xylix)
"w" = (
/turf/closed/wall/mineral/decostone/moss/blue/long{
	dir = 1
	},
/area/rogue/under/xylix)
"y" = (
/obj/structure/trap/wall_projectile/hidden{
	dir = 8
	},
/turf/open/floor/concrete,
/area/rogue/under/xylix)
"A" = (
/turf/closed/wall/mineral/decostone/moss/blue/long,
/area/rogue/under/xylix)
"D" = (
/obj/structure/trap/wall_projectile/hidden{
	dir = 4
	},
/turf/open/floor/concrete,
/area/rogue/under/xylix)
"I" = (
/turf/closed/wall/mineral/decostone/moss/blue/end{
	dir = 4
	},
/area/rogue/under/xylix)
"J" = (
/obj/structure/fluff/walldeco/vinez/blue,
/turf/open/floor/concrete,
/area/rogue/under/xylix)
"K" = (
/obj/structure/fluff/walldeco/xylixhint_danger,
/obj/structure/fluff/walldeco/vinez/blue,
/turf/open/floor/concrete,
/area/rogue/under/xylix)
"L" = (
/obj/structure/fluff/walldeco/xylixhint_danger,
/turf/open/floor/concrete,
/area/rogue/under/xylix)
"M" = (
/turf/open/floor/metal/barograte,
/area/rogue/under/xylix)
"O" = (
/turf/open/floor/concrete,
/area/rogue/under/xylix)
"V" = (
/obj/machinery/light/fueled/firebowl,
/turf/open/floor/concrete,
/area/rogue/under/xylix)
"W" = (
/turf/open/floor/blocks/moss,
/area/rogue/under/xylix)

(1,1,1) = {"
p
a
A
a
d
M
M
d
a
A
A
a
"}
(2,1,1) = {"
a
w
O
O
O
O
O
O
O
O
O
w
"}
(3,1,1) = {"
a
w
L
V
f
V
L
V
K
V
L
w
"}
(4,1,1) = {"
a
w
O
l
O
l
D
l
J
l
O
w
"}
(5,1,1) = {"
a
w
y
w
O
w
O
w
c
w
D
w
"}
(6,1,1) = {"
a
w
y
w
J
w
y
w
O
w
O
w
"}
(7,1,1) = {"
a
w
y
I
J
I
O
I
O
I
y
w
"}
(8,1,1) = {"
a
w
O
V
J
V
y
V
D
V
D
w
"}
(9,1,1) = {"
a
w
O
O
O
O
O
O
O
O
O
w
"}
(10,1,1) = {"
a
a
a
O
a
O
a
O
a
O
a
a
"}
(11,1,1) = {"
a
w
O
O
O
O
O
O
O
O
O
w
"}
(12,1,1) = {"
p
a
A
a
d
W
d
W
a
A
A
a
"}
