//MAP CONVERTED BY dmm2tgm.py THIS HEADER COMMENT PREVENTS RECONVERSION, DO NOT REMOVE
"a" = (
/turf/closed/wall/mineral/decostone/moss/blue,
/area/rogue/under/xylix)
"d" = (
/turf/open/floor/cobblemoss,
/area/rogue/under/xylix)
"h" = (
/turf/open/floor/blocks/moss,
/area/rogue/under/xylix)
"m" = (
/obj/structure/fluff/walldeco/xylixhint,
/turf/open/floor/concrete,
/area/rogue/under/xylix)
"o" = (
/obj/structure/trap/wall_projectile/hidden{
	dir = 8
	},
/turf/open/floor/concrete,
/area/rogue/under/xylix)
"p" = (
/turf/closed/wall/mineral/decostone/moss/blue/end{
	dir = 8
	},
/area/rogue/under/xylix)
"w" = (
/turf/closed/wall/mineral/decostone/moss/blue/long{
	dir = 1
	},
/area/rogue/under/xylix)
"x" = (
/obj/structure/fluff/walldeco/xylixhint,
/obj/structure/fluff/walldeco/vinez/blue,
/turf/open/floor/concrete,
/area/rogue/under/xylix)
"A" = (
/turf/closed/wall/mineral/decostone/moss/blue/long,
/area/rogue/under/xylix)
"D" = (
/obj/structure/trap/wall_projectile/hidden{
	dir = 4
	},
/turf/open/floor/concrete,
/area/rogue/under/xylix)
"F" = (
/obj/structure/fluff/walldeco/vinez/blue,
/turf/open/floor/concrete,
/area/rogue/under/xylix)
"I" = (
/turf/closed/wall/mineral/decostone/moss/blue/end{
	dir = 4
	},
/area/rogue/under/xylix)
"J" = (
/obj/structure/fluff/walldeco/xylixhint_danger,
/obj/structure/fluff/walldeco/vinez/blue,
/turf/open/floor/concrete,
/area/rogue/under/xylix)
"K" = (
/obj/structure/fluff/walldeco/xylixhint_danger,
/turf/open/floor/concrete,
/area/rogue/under/xylix)
"M" = (
/turf/open/floor/metal/barograte,
/area/rogue/under/xylix)
"O" = (
/turf/open/floor/concrete,
/area/rogue/under/xylix)
"R" = (
/obj/structure/trap/wall_projectile/hidden{
	dir = 8
	},
/obj/structure/fluff/walldeco/vinez/blue,
/turf/open/floor/concrete,
/area/rogue/under/xylix)
"V" = (
/obj/machinery/light/fueled/firebowl,
/turf/open/floor/concrete,
/area/rogue/under/xylix)

(1,1,1) = {"
a
a
A
a
d
M
M
d
a
A
A
a
"}
(2,1,1) = {"
a
w
O
O
O
O
O
O
O
O
O
w
"}
(3,1,1) = {"
a
w
K
V
K
V
J
V
m
V
x
w
"}
(4,1,1) = {"
a
w
O
p
O
p
D
p
O
p
F
w
"}
(5,1,1) = {"
a
w
D
w
O
w
O
w
O
w
O
w
"}
(6,1,1) = {"
a
w
D
w
D
w
R
w
O
w
O
w
"}
(7,1,1) = {"
a
w
o
I
O
I
F
I
O
I
F
w
"}
(8,1,1) = {"
a
w
O
V
o
V
R
V
O
V
O
w
"}
(9,1,1) = {"
a
w
O
O
O
O
O
O
O
O
O
w
"}
(10,1,1) = {"
a
a
a
O
a
O
a
O
a
O
a
a
"}
(11,1,1) = {"
a
w
O
O
O
O
O
O
O
O
O
w
"}
(12,1,1) = {"
a
a
A
a
d
h
d
h
a
A
A
a
"}
