//MAP CONVERTED BY dmm2tgm.py THIS HEADER COMMENT PREVENTS RECONVERSION, DO NOT REMOVE
"a" = (
/turf/open/floor/naturalstone,
/area/rogue/under/town/caverogue/saltmine)
"o" = (
/obj/item/gem/green{
	pixel_x = -1
	},
/obj/item/natural/rock,
/turf/open/floor/naturalstone,
/area/rogue/under/town/caverogue/saltmine)
"u" = (
/turf/closed/mineral,
/area/rogue/under/town/caverogue/saltmine)
"I" = (
/turf/closed/mineral/salt,
/area/rogue/under/town/caverogue/saltmine)
"L" = (
/obj/item/natural/stone,
/turf/open/floor/naturalstone,
/area/rogue/under/town/caverogue/saltmine)

(1,1,1) = {"
a
a
L
a
"}
(2,1,1) = {"
a
u
u
a
"}
(3,1,1) = {"
a
u
I
a
"}
(4,1,1) = {"
o
a
a
a
"}
