//MAP CONVERTED BY dmm2tgm.py THIS HEADER COMMENT PREVENTS RECONVERSION, DO NOT REMOVE
"ab" = (
/turf/open/floor/naturalstone,
/area/rogue/under/cave/sumpgrotto)
"aj" = (
/obj/structure/fluff/walldeco/skullspike,
/turf/closed/mineral/bedrock,
/area/rogue/under/cave/sumpgrotto)
"bH" = (
/obj/effect/decal/cleanable/blood_neu/tracks{
	dir = 4
	},
/turf/open/floor/naturalstone,
/area/rogue/under/cave/sumpgrotto)
"bO" = (
/obj/effect/decal/cleanable/blood_neu/tracks,
/obj/structure/fluff/walldeco/skullspike,
/turf/open/floor/naturalstone,
/area/rogue/under/cave/sumpgrotto)
"ch" = (
/obj/structure/barricade/wooden,
/obj/structure/fluff/walldeco/vinez,
/turf/closed/mineral/bedrock,
/area/rogue/under/cave/sumpgrotto)
"do" = (
/obj/structure/roguetent/preopen,
/turf/open/floor/naturalstone,
/area/rogue/under/cave/sumpgrotto)
"ds" = (
/obj/structure/closet/crate/chest/wicker,
/obj/item/ore/copper,
/obj/item/ore/copper,
/turf/open/floor/twig,
/area/rogue/under/cave/sumpgrotto)
"ef" = (
/turf/closed/mineral/bedrock,
/area/rogue/under/cave/sumpgrotto)
"eo" = (
/obj/item/bin/water/gross,
/turf/open/floor/naturalstone,
/area/rogue/under/cave/sumpgrotto)
"es" = (
/obj/structure/rack,
/obj/item/clothing/armor/cuirass/iron/goblin,
/turf/open/floor/twig,
/area/rogue/under/cave/sumpgrotto)
"eN" = (
/obj/structure/table/wood/crafted,
/obj/item/alch/sinew,
/turf/open/floor/naturalstone,
/area/rogue/under/cave/sumpgrotto)
"gp" = (
/obj/structure/barricade/wooden,
/turf/closed/mineral/bedrock,
/area/rogue/under/cave/sumpgrotto)
"gM" = (
/obj/structure/fluff/railing/fence{
	dir = 1
	},
/turf/open/floor/naturalstone,
/area/rogue/under/cave/sumpgrotto)
"ii" = (
/obj/structure/closet/crate/chest/wicker,
/obj/item/natural/hide,
/obj/item/natural/hide,
/obj/item/natural/hide,
/turf/open/floor/twig,
/area/rogue/under/cave/sumpgrotto)
"io" = (
/obj/machinery/light/fueled/torchholder/r,
/turf/open/floor/twig,
/area/rogue/under/cave/sumpgrotto)
"jg" = (
/obj/effect/decal/remains/bigrat,
/obj/effect/decal/cleanable/blood_neu/random,
/turf/open/floor/naturalstone,
/area/rogue/under/cave/sumpgrotto)
"jS" = (
/obj/structure/flora/shroom_tree_neu,
/turf/open/water/swamp,
/area/rogue/under/cave/sumpgrotto)
"kE" = (
/obj/structure/fluff/walldeco/rags/skull,
/turf/closed/mineral/bedrock,
/area/rogue/under/cave/sumpgrotto)
"kO" = (
/turf/open/water/swamp,
/area/rogue/under/cave/sumpgrotto)
"lc" = (
/obj/effect/decal/cleanable/blood_neu/tracks{
	dir = 4
	},
/mob/living/carbon/human/species/goblin/npc/ambush/cave,
/turf/open/floor/naturalstone,
/area/rogue/under/cave/sumpgrotto)
"lD" = (
/mob/living/carbon/human/species/goblin/npc/ambush/cave,
/turf/open/floor/twig,
/area/rogue/under/cave/sumpgrotto)
"mA" = (
/obj/structure/fluff/walldeco/rags/alt,
/obj/structure/barricade/wooden,
/turf/closed/mineral/bedrock,
/area/rogue/under/cave/sumpgrotto)
"mE" = (
/obj/structure/closet/crate/chest/wicker,
/obj/item/alch/bone,
/obj/item/alch/bone,
/obj/item/reagent_containers/food/snacks/fat,
/obj/item/reagent_containers/food/snacks/fat,
/turf/open/floor/twig,
/area/rogue/under/cave/sumpgrotto)
"ng" = (
/obj/item/clothing/cloak/wickercloak,
/obj/structure/closet/crate/chest/wicker,
/turf/open/floor/twig,
/area/rogue/under/cave/sumpgrotto)
"oP" = (
/turf/closed/wall/mineral/tent,
/area/rogue/under/cave/sumpgrotto)
"pq" = (
/obj/structure/flora/shroom_tree_neu,
/turf/open/floor/naturalstone,
/area/rogue/under/cave/sumpgrotto)
"pu" = (
/obj/structure/fluff/walldeco/skullspike,
/turf/open/floor/naturalstone,
/area/rogue/under/cave/sumpgrotto)
"pF" = (
/obj/effect/spawner/map_spawner/loot/coin/low,
/turf/open/floor/twig,
/area/rogue/under/cave/sumpgrotto)
"pJ" = (
/obj/structure/fluff/railing/fence,
/turf/open/floor/naturalstone,
/area/rogue/under/cave/sumpgrotto)
"pN" = (
/obj/structure/remains/human,
/turf/open/floor/dirt/muddie,
/area/rogue/under/cave/sumpgrotto)
"pZ" = (
/obj/item/grown/log/tree/small,
/obj/item/grown/log/tree/small,
/obj/structure/rack,
/turf/open/floor/naturalstone,
/area/rogue/under/cave/sumpgrotto)
"qr" = (
/obj/effect/spawner/map_spawner/rockies,
/turf/open/floor/dirt/muddie,
/area/rogue/under/cave/sumpgrotto)
"qt" = (
/obj/structure/flora/shroom_tree_neu,
/turf/open/floor/dirt/muddie,
/area/rogue/under/cave/sumpgrotto)
"qv" = (
/obj/structure/closet/crate/chest/rotting,
/obj/item/clothing/neck/bogcowl,
/obj/item/storage/backpack/satchel,
/turf/open/floor/twig,
/area/rogue/under/cave/sumpgrotto)
"ri" = (
/obj/effect/spawner/map_spawner/bogdirt,
/turf/open/floor/naturalstone,
/area/rogue/under/cave/sumpgrotto)
"rs" = (
/turf/closed/mineral/random,
/area/rogue/under/cave/sumpgrotto)
"rW" = (
/obj/effect/spawner/map_spawner/rockies,
/turf/open/water/swamp,
/area/rogue/under/cave/sumpgrotto)
"rY" = (
/obj/machinery/light/fueled/campfire/longlived,
/turf/open/floor/naturalstone,
/area/rogue/under/cave/sumpgrotto)
"sf" = (
/obj/effect/decal/remains/mole,
/obj/effect/decal/cleanable/blood_neu/random,
/turf/open/floor/dirt/muddie,
/area/rogue/under/cave/sumpgrotto)
"sT" = (
/obj/machinery/light/fueled/forge,
/turf/open/floor/naturalstone,
/area/rogue/under/cave/sumpgrotto)
"te" = (
/obj/structure/barricade/wooden,
/turf/open/floor/naturalstone,
/area/rogue/under/cave/sumpgrotto)
"tB" = (
/obj/structure/table/wood/crafted,
/turf/open/floor/twig,
/area/rogue/under/cave/sumpgrotto)
"tG" = (
/obj/structure/table/wood/crafted,
/obj/item/cooking/pan,
/turf/open/floor/twig,
/area/rogue/under/cave/sumpgrotto)
"tW" = (
/obj/structure/flora/grass/water,
/turf/open/floor/dirt/muddie,
/area/rogue/under/cave/sumpgrotto)
"ua" = (
/obj/item/reagent_containers/glass/bottle/beer/voddena,
/turf/open/floor/twig,
/area/rogue/under/cave/sumpgrotto)
"up" = (
/obj/structure/meathook,
/obj/effect/decal/cleanable/blood_neu/random,
/obj/effect/decal/remains/human,
/turf/open/floor/naturalstone,
/area/rogue/under/cave/sumpgrotto)
"uZ" = (
/obj/effect/spawner/map_spawner/rat_danger,
/turf/open/floor/naturalstone,
/area/rogue/under/cave/sumpgrotto)
"vn" = (
/obj/effect/decal/remains/bigrat,
/turf/open/floor/dirt/muddie,
/area/rogue/under/cave/sumpgrotto)
"vF" = (
/obj/structure/gob_portal,
/turf/open/floor/dirt/muddie,
/area/rogue/under/cave/sumpgrotto)
"vM" = (
/obj/effect/decal/cleanable/blood_neu/random,
/turf/open/floor/dirt/muddie,
/area/rogue/under/cave/sumpgrotto)
"xd" = (
/obj/structure/table/wood/crafted,
/obj/item/candle/skull/lit,
/turf/open/floor/twig,
/area/rogue/under/cave/sumpgrotto)
"xp" = (
/obj/effect/spawner/map_spawner/loot/medium,
/turf/open/floor/dirt/muddie,
/area/rogue/under/cave/sumpgrotto)
"yv" = (
/obj/structure/closet/crate/chest/wicker,
/obj/item/reagent_containers/food/snacks/meat/strange,
/obj/item/reagent_containers/food/snacks/meat/strange,
/obj/item/reagent_containers/food/snacks/meat/strange,
/turf/open/floor/twig,
/area/rogue/under/cave/sumpgrotto)
"zJ" = (
/obj/item/storage/sack,
/turf/open/floor/naturalstone,
/area/rogue/under/cave/sumpgrotto)
"Ak" = (
/obj/structure/closet/crate/chest/wicker,
/obj/item/reagent_containers/food/snacks/meat/human,
/obj/item/reagent_containers/food/snacks/meat/human,
/obj/item/reagent_containers/food/snacks/meat/human,
/turf/open/floor/naturalstone,
/area/rogue/under/cave/sumpgrotto)
"Au" = (
/obj/structure/flora/grass/water/reeds,
/turf/open/floor/dirt/muddie,
/area/rogue/under/cave/sumpgrotto)
"Ay" = (
/turf/open/floor/twig,
/area/rogue/under/cave/sumpgrotto)
"BD" = (
/obj/structure/kneestingers,
/turf/open/floor/naturalstone,
/area/rogue/under/cave/sumpgrotto)
"BG" = (
/obj/effect/decal/cleanable/vomit/old,
/turf/open/floor/naturalstone,
/area/rogue/under/cave/sumpgrotto)
"CC" = (
/obj/effect/landmark/mapGenerator/sump_grotto,
/turf/closed/basic,
/area/rogue/under/cave/sumpgrotto)
"CH" = (
/obj/effect/decal/remains/bigrat,
/turf/open/water/swamp,
/area/rogue/under/cave/sumpgrotto)
"Dv" = (
/mob/living/carbon/human/species/goblin/npc/ambush/cave,
/turf/open/floor/dirt/muddie,
/area/rogue/under/cave/sumpgrotto)
"DL" = (
/obj/effect/spawner/map_spawner/maybe_trap,
/turf/open/floor/naturalstone,
/area/rogue/under/cave/sumpgrotto)
"EY" = (
/obj/structure/flora/grass/water,
/turf/open/water/swamp,
/area/rogue/under/cave/sumpgrotto)
"FJ" = (
/obj/structure/fluff/walldeco/rags,
/turf/closed/wall/mineral/tent,
/area/rogue/under/cave/sumpgrotto)
"FL" = (
/obj/structure/closet/crate/chest/rotting,
/obj/item/needle/thorn,
/turf/open/floor/naturalstone,
/area/rogue/under/cave/sumpgrotto)
"HZ" = (
/obj/effect/spawner/map_spawner/rockies,
/turf/open/floor/naturalstone,
/area/rogue/under/cave/sumpgrotto)
"If" = (
/obj/structure/table/wood/crafted,
/obj/effect/decal/cleanable/blood_neu/random,
/obj/item/reagent_containers/glass/cup/skull,
/turf/open/floor/naturalstone,
/area/rogue/under/cave/sumpgrotto)
"Is" = (
/obj/item/rope,
/turf/open/floor/twig,
/area/rogue/under/cave/sumpgrotto)
"Jm" = (
/turf/open/floor/dirt/muddie,
/area/rogue/under/cave/sumpgrotto)
"JC" = (
/obj/structure/fluff/walldeco/rags/skull,
/obj/structure/barricade/wooden,
/turf/closed/mineral/bedrock,
/area/rogue/under/cave/sumpgrotto)
"KM" = (
/obj/structure/table/wood/crafted,
/obj/item/weapon/tongs/stone,
/turf/open/floor/naturalstone,
/area/rogue/under/cave/sumpgrotto)
"KO" = (
/turf/closed/wall/mineral/roofwall/center,
/area/rogue/under/cave/sumpgrotto)
"KR" = (
/obj/effect/decal/cleanable/blood_neu/tracks{
	dir = 6
	},
/turf/open/floor/naturalstone,
/area/rogue/under/cave/sumpgrotto)
"Lf" = (
/obj/structure/remains/human,
/obj/effect/spawner/map_spawner/artefact_sumpgrotto,
/turf/open/water/swamp,
/area/rogue/under/cave/sumpgrotto)
"LB" = (
/turf/open/water/cleanshallow,
/area/rogue/under/cave)
"LD" = (
/obj/structure/fluff/walldeco/rags/alt,
/obj/structure/barricade/wooden,
/obj/structure/fluff/walldeco/vinez,
/turf/closed/mineral/bedrock,
/area/rogue/under/cave/sumpgrotto)
"LR" = (
/obj/machinery/light/fueled/torchholder/c,
/turf/open/floor/twig,
/area/rogue/under/cave/sumpgrotto)
"LU" = (
/obj/machinery/light/fueled/torchholder/c,
/turf/open/floor/naturalstone,
/area/rogue/under/cave/sumpgrotto)
"Mo" = (
/obj/structure/closet/crate/chest/wicker,
/obj/item/ore/tin,
/turf/open/floor/naturalstone,
/area/rogue/under/cave/sumpgrotto)
"Mu" = (
/obj/machinery/anvil,
/obj/item/weapon/hammer/iron,
/turf/open/floor/naturalstone,
/area/rogue/under/cave/sumpgrotto)
"Ng" = (
/obj/structure/fluff/railing/fence{
	dir = 4
	},
/turf/open/floor/naturalstone,
/area/rogue/under/cave/sumpgrotto)
"PO" = (
/obj/effect/decal/cleanable/blood_neu/tracks,
/mob/living/carbon/human/species/goblin/npc/ambush/cave,
/turf/open/floor/naturalstone,
/area/rogue/under/cave/sumpgrotto)
"Qr" = (
/obj/effect/decal/cleanable/blood_neu/random,
/turf/open/floor/naturalstone,
/area/rogue/under/cave/sumpgrotto)
"Qs" = (
/obj/machinery/light/fueled/torchholder/c,
/obj/structure/closet/crate/chest/wicker,
/obj/item/clothing/neck/menears,
/obj/item/reagent_containers/glass/bottle/healthpot,
/turf/open/floor/twig,
/area/rogue/under/cave/sumpgrotto)
"Qy" = (
/obj/structure/closet/crate/chest/rotting,
/obj/item/ingot/iron,
/turf/open/floor/twig,
/area/rogue/under/cave/sumpgrotto)
"QK" = (
/obj/item/weapon/knife/stone,
/obj/structure/table/wood/crafted,
/turf/open/floor/naturalstone,
/area/rogue/under/cave/sumpgrotto)
"Re" = (
/obj/machinery/light/fueled/hearth,
/turf/open/floor/naturalstone,
/area/rogue/under/cave/sumpgrotto)
"Ri" = (
/obj/effect/decal/remains/bigrat,
/turf/open/floor/naturalstone,
/area/rogue/under/cave/sumpgrotto)
"Rn" = (
/obj/item/weapon/axe/stone,
/obj/structure/table/wood/crafted,
/turf/open/floor/twig,
/area/rogue/under/cave/sumpgrotto)
"Ro" = (
/obj/effect/spawner/map_spawner/bogdirt,
/turf/open/floor/dirt/muddie,
/area/rogue/under/cave/sumpgrotto)
"RD" = (
/obj/structure/fluff/walldeco/rags,
/obj/structure/barricade/wooden,
/turf/closed/mineral/bedrock,
/area/rogue/under/cave/sumpgrotto)
"RJ" = (
/mob/living/simple_animal/hostile/retaliate/gator,
/turf/open/water/swamp,
/area/rogue/under/cave/sumpgrotto)
"RN" = (
/obj/structure/fluff/walldeco/vinez,
/turf/closed/mineral/bedrock,
/area/rogue/under/cave/sumpgrotto)
"SY" = (
/obj/machinery/light/fueled/smelter,
/turf/open/floor/naturalstone,
/area/rogue/under/cave/sumpgrotto)
"Tf" = (
/obj/structure/roguetent/preopen,
/turf/open/floor/twig,
/area/rogue/under/cave/sumpgrotto)
"Th" = (
/obj/effect/decal/remains/mole,
/turf/open/water/swamp,
/area/rogue/under/cave/sumpgrotto)
"Tr" = (
/obj/structure/well/climb_up,
/turf/open/water/cleanshallow,
/area/rogue/under/cave)
"UX" = (
/obj/machinery/tanningrack,
/turf/open/floor/naturalstone,
/area/rogue/under/cave/sumpgrotto)
"VB" = (
/obj/effect/decal/cleanable/blood_neu/tracks{
	dir = 9
	},
/turf/open/floor/naturalstone,
/area/rogue/under/cave/sumpgrotto)
"Xt" = (
/obj/effect/decal/cleanable/blood_neu/tracks,
/turf/open/floor/naturalstone,
/area/rogue/under/cave/sumpgrotto)
"Yk" = (
/mob/living/carbon/human/species/goblin/npc/ambush/cave,
/turf/open/floor/naturalstone,
/area/rogue/under/cave/sumpgrotto)
"YB" = (
/obj/structure/bed/shit,
/turf/open/floor/twig,
/area/rogue/under/cave/sumpgrotto)
"YU" = (
/obj/effect/decal/cleanable/blood_neu/random,
/obj/effect/decal/cleanable/blood_neu/tracks{
	dir = 4
	},
/turf/open/floor/naturalstone,
/area/rogue/under/cave/sumpgrotto)
"Zf" = (
/obj/structure/closet/crate/chest/wicker,
/obj/item/ore/iron,
/obj/item/ore/iron,
/obj/item/ore/iron,
/turf/open/floor/naturalstone,
/area/rogue/under/cave/sumpgrotto)
"ZJ" = (
/obj/structure/bed/shit,
/turf/open/floor/naturalstone,
/area/rogue/under/cave/sumpgrotto)

(1,1,1) = {"
ef
ef
ef
ef
ef
ef
ef
ef
ef
ef
ef
ef
ef
ef
ef
ef
ef
ef
ef
ef
ef
ef
ef
ef
ef
ef
ef
ef
ef
ef
ef
ef
ef
ef
ef
ef
ef
ef
ef
ef
ef
ef
ef
ef
ef
ef
ef
ef
ef
ef
ef
ef
ef
ef
ef
ef
ef
ef
ef
ef
ef
ef
ef
ef
CC
"}
(2,1,1) = {"
ef
ef
ef
ef
ef
ef
ef
ef
ef
ef
ef
ef
ef
ef
ef
ef
ef
ef
RN
ef
RN
RN
ef
ef
ef
ef
ef
ef
ef
ef
ef
ef
ef
ef
ef
ef
ef
ef
ef
ef
ef
ef
ef
ef
ef
ef
ef
ef
ef
ef
ef
ef
ef
ef
ef
ef
ef
ef
ef
ef
ef
ef
ef
ef
ef
"}
(3,1,1) = {"
ef
ef
ef
ef
ef
ef
ef
ef
ef
ef
ef
ef
ef
ef
ef
ef
ch
ch
kO
Jm
ab
ab
ab
HZ
aj
RN
RN
ef
ef
ef
ef
ef
ef
ef
ef
ef
ef
ef
ef
ef
ef
ef
ef
ef
ef
ef
ef
ef
ef
ef
ef
ef
ef
ef
ef
ef
ef
ef
ef
ef
ef
ef
ef
ef
ef
"}
(4,1,1) = {"
ef
ef
ef
ef
ef
ef
ef
RN
ef
ef
ef
ef
ef
ef
ef
ch
QK
eN
Jm
ab
ab
ab
ab
ab
ab
ab
ab
ef
ef
ef
ef
ef
ef
ef
ef
ef
ef
ef
ef
ef
ef
ef
ef
ef
ef
ef
ef
ef
ef
ef
ef
ef
ef
ef
ef
ef
ef
ef
ef
ef
ef
ef
ef
ef
ef
"}
(5,1,1) = {"
ef
ef
ef
ef
RN
ab
ab
ri
ab
ab
ef
ef
ef
ef
RN
ua
Ay
Ay
ab
ab
ab
BG
ab
ab
ab
ab
ab
ab
ef
ef
ef
ef
ef
ef
ef
ef
ef
ef
ef
ef
ef
ef
ef
ef
ef
ef
ef
ef
ef
ef
ef
ef
ef
ef
ef
ef
ef
ef
ef
ef
ef
ef
ef
ef
ef
"}
(6,1,1) = {"
ef
ef
ef
RN
ri
Jm
ab
ab
ab
ab
ab
ab
ab
mA
HZ
lD
rY
ab
oP
oP
oP
oP
eo
ab
ab
ab
ab
ab
ab
ab
RN
ef
ef
ef
ef
ef
ef
ef
ef
ef
ef
ef
ef
ef
ef
ef
ef
ef
ef
ef
ef
ef
ef
ef
ef
ef
ef
ef
ef
ef
ef
ef
ef
ef
ef
"}
(7,1,1) = {"
ef
ef
ef
RN
Jm
kO
Jm
ab
ab
ab
ab
ab
ab
ab
ab
Ay
Ay
lD
oP
ab
YB
oP
gp
gp
RN
Jm
ab
ab
ab
ab
Jm
RN
ef
ef
ef
ef
ef
ef
ef
ef
ef
ef
ef
ef
ef
ef
ef
ef
ef
ef
ef
ef
ef
ef
ef
ef
ef
ef
ef
ef
ef
ef
ef
ef
ef
"}
(8,1,1) = {"
ef
ef
RN
Jm
Jm
Jm
ab
ab
ab
ab
ab
ab
ab
ab
ab
ab
ab
Ay
do
Ay
Ay
oP
ef
ef
ef
HZ
ab
ab
ab
Jm
Jm
ab
ef
ef
ef
ef
ef
ef
ef
ef
ef
ef
ef
ef
ef
ef
ef
ef
ef
ef
ef
ef
ef
ef
ef
ef
ef
ef
ef
ef
ef
ef
ef
ef
ef
"}
(9,1,1) = {"
ef
ef
kO
qt
ab
ab
ab
ef
RN
RN
ef
ef
ef
ab
ab
ab
ab
Ay
oP
qv
io
oP
ef
ef
ef
ef
RN
ef
ri
ab
Jm
ab
ef
ef
ef
ef
ef
ef
ef
ef
ef
ef
ef
ef
ef
ef
ef
ef
ef
ef
ef
ef
ef
ef
ef
ef
ef
ef
ef
ef
ef
ef
ef
ef
ef
"}
(10,1,1) = {"
ef
ef
kO
Jm
ab
ab
ef
ef
ef
ef
ef
ef
ef
mA
ab
ab
ab
ab
ef
gp
gp
gp
ef
ef
ef
ef
ef
ef
ef
ab
ab
ab
ab
ef
ef
ef
ef
ef
ef
ef
ef
ef
ef
ef
ef
ef
ef
ef
ef
ef
ef
ef
ef
ef
ef
ef
ef
ef
ef
ef
ef
ef
ef
ef
ef
"}
(11,1,1) = {"
ef
ef
qt
ab
ab
HZ
RN
ef
ef
ef
ef
ef
ef
mA
ab
ab
ab
ab
aj
ef
ef
ef
ef
ef
ef
ef
ef
ef
ef
ab
ab
ab
ab
ri
ab
ef
RN
ef
ef
ef
ef
ef
ef
ef
ef
ef
ef
ef
ef
ef
ef
ef
ef
ef
ef
ef
ef
ef
ef
ef
ef
ef
ef
ef
ef
"}
(12,1,1) = {"
ef
ef
Jm
ab
ab
ef
ef
ef
ef
ef
ef
ef
ef
LD
Jm
ab
ab
ab
ab
ef
RN
RN
ef
ef
ef
ef
ef
ef
ef
ef
ab
ab
ab
ab
ab
ab
HZ
RN
ef
ef
ef
ef
ef
ef
ef
ef
ef
ef
ef
ef
ef
ef
ef
ef
ef
ef
ef
ef
ef
ef
ef
ef
ef
ef
ef
"}
(13,1,1) = {"
ef
RN
ab
ab
ab
ef
ef
ef
ef
ef
ef
ef
ef
ef
ef
ef
ab
ab
ab
ab
ri
Jm
RN
ef
ef
ef
ef
ef
ef
ef
RN
ab
ab
ab
ab
ab
ab
RN
ef
ef
ef
ef
ef
ef
ef
ef
ef
ef
ef
ef
ef
ef
ef
ef
ef
ef
ef
ef
ef
ef
ef
ef
ef
ef
ef
"}
(14,1,1) = {"
ef
RN
ab
ab
ab
RN
ef
ef
ef
ef
ef
ef
ef
RN
RN
RN
Jm
ab
ab
ab
ab
ab
RN
RN
ef
ef
ef
ef
ef
ef
ef
RN
RN
ab
ab
ab
ab
Jm
ef
ef
ef
ef
ef
ef
ef
ef
ef
ef
ef
ef
ef
ef
ef
ef
ef
ef
ef
ef
ef
ef
ef
ef
ef
ef
ef
"}
(15,1,1) = {"
ef
ef
ab
ab
ab
RN
ef
ef
ef
ef
ef
RN
RN
kO
Jm
Jm
ab
ab
ab
ab
ab
ab
Jm
Jm
RN
ef
ef
ef
ef
ef
LB
LB
ef
ef
ab
ab
Jm
Jm
ef
ef
ef
ef
ef
ef
ef
ef
ef
ef
ef
ef
ef
ef
ef
ef
ef
ef
ef
ef
ef
ef
ef
ef
ef
ef
ef
"}
(16,1,1) = {"
ef
ef
ab
ab
ab
ef
ef
ef
ef
ef
ab
ab
Ro
Jm
Jm
uZ
ab
ef
ef
RN
ab
ab
ab
Jm
RN
ef
ef
ef
ef
ef
Tr
LB
ef
ef
kE
ab
ab
Jm
ef
ef
ef
ef
ef
ef
ef
ef
ef
ef
ef
ef
ef
ef
ef
ef
ef
ef
ef
ef
ef
ef
ef
ef
ef
ef
ef
"}
(17,1,1) = {"
ef
RN
ab
ab
ab
ab
ef
ef
HZ
ab
ab
ab
ab
Jm
kO
ef
ef
ef
ef
ef
ab
ab
ab
uZ
ab
ef
ef
ef
ef
ef
ef
ef
ef
ef
ef
ab
ab
ab
ef
ef
ef
ef
ef
ef
ef
ef
ef
ef
ef
ef
ef
ef
ef
ef
ef
ef
ef
ef
ef
ef
ef
ef
ef
ef
ef
"}
(18,1,1) = {"
ef
ef
ab
ri
ab
ab
ab
ab
ab
ab
ab
ab
Jm
qt
ef
ef
ef
ef
ef
ef
ef
ab
ab
ab
ab
ef
ef
ef
ef
ef
ef
ef
ef
ef
pq
ab
ab
ab
ef
ef
ef
ef
ef
ef
ef
ef
ef
ef
ef
ef
ef
ef
ef
ef
ef
ef
ef
ef
ef
ef
ef
ef
ef
ef
ef
"}
(19,1,1) = {"
ef
ef
RN
Jm
Jm
ab
ab
ab
ab
ab
ab
ab
ab
ab
ab
RN
ef
ef
ef
ef
ef
RN
ab
ab
ab
ef
ef
RN
ef
RN
RN
HZ
ab
ab
ab
ab
ab
ab
ef
ef
ef
ef
ef
ef
ef
ef
ef
ef
ef
ef
ef
ef
ef
ef
ef
ef
ef
ef
ef
ef
ef
ef
ef
ef
ef
"}
(20,1,1) = {"
ef
ef
ef
ef
Jm
Jm
ab
ab
ab
ab
ab
ab
ab
ab
Jm
RN
ef
ef
ef
ef
ef
RN
ab
ab
ab
ef
RN
Ro
Jm
ab
ab
ab
ab
ab
ab
ab
ab
ri
ef
ef
ef
ef
ef
ef
ef
ef
ef
ef
ef
ef
ef
ef
ef
ef
ef
ef
ef
ef
ef
ef
ef
ef
ef
ef
ef
"}
(21,1,1) = {"
ef
ef
ef
RN
vF
Jm
ab
ab
ab
ef
ef
RN
ab
ab
Jm
kO
rW
ef
ef
ef
ef
ef
ab
ab
ab
ab
ab
ab
ab
ab
ab
ab
ab
ab
ab
ab
ab
ab
RN
ef
ef
ef
ef
ef
ef
ef
ef
ef
ef
ef
ef
ef
ef
ef
ef
ef
ef
ef
ef
ef
ef
ef
ef
ef
ef
"}
(22,1,1) = {"
ef
ef
ef
RN
Jm
Jm
ab
ab
ab
ef
ef
RN
ab
Jm
Jm
Jm
kO
RN
ef
ef
ef
ef
ef
ab
ab
ab
ab
ab
ab
ab
ab
ab
ab
ab
ab
ab
ab
ab
ab
ef
ef
ef
ef
ef
ef
ef
ef
ef
ef
ef
ef
ef
ef
ef
ef
ef
ef
ef
ef
ef
ef
ef
ef
ef
ef
"}
(23,1,1) = {"
ef
ef
ef
RN
Jm
ri
ab
ab
ef
ef
ef
ef
ef
qt
kO
Jm
Jm
pq
ef
ef
ef
ef
ef
ab
ab
ab
ab
ab
RN
ef
kE
ab
ab
ab
ef
ef
ab
ab
ab
ab
ef
ef
ef
ef
ef
ef
ef
ef
ef
ef
ef
ef
ef
ef
ef
ef
ef
ef
ef
ef
ef
ef
ef
ef
ef
"}
(24,1,1) = {"
ef
ef
ef
RN
ab
ab
ab
HZ
ef
ef
ef
ef
ef
RN
kO
Jm
ab
ab
RN
ef
ef
ef
ef
ab
ab
ab
ef
RN
ef
ef
RN
Jm
ab
ab
RN
ef
ef
ab
ab
ab
ab
ef
ef
ef
ef
ef
ef
KO
ef
ef
ef
ef
ef
ef
ef
ef
ef
ef
ef
ef
ef
ef
ef
ef
ef
"}
(25,1,1) = {"
ef
ef
ef
ef
ab
ab
ab
ef
ef
ef
ef
ef
ef
RN
Jm
qt
ab
Jm
RN
ef
ef
ef
te
ab
ab
ri
ef
ef
ef
ef
RN
ri
ab
uZ
RN
RN
ef
ab
ab
ab
ab
ef
ef
ef
ef
ef
KO
ef
ef
ef
ef
ef
ef
ef
ef
ef
ef
ef
ef
ef
ef
ef
ef
ef
ef
"}
(26,1,1) = {"
ef
ef
ef
ef
ri
ab
ab
ef
ef
ef
ef
ef
qr
Jm
Jm
Jm
Jm
Dv
kO
jS
RN
RN
ab
te
te
ef
ef
ef
ef
ef
ef
ef
ab
ab
Jm
Jm
RN
pu
ab
ab
ab
ab
ab
ab
ef
KO
KO
KO
KO
KO
KO
KO
ef
ef
ef
ef
ef
ef
ef
ef
ef
ef
ef
ef
ef
"}
(27,1,1) = {"
ef
ef
ef
ef
ab
ab
ab
RN
ef
ef
ef
qt
Jm
Jm
Dv
Jm
ab
ab
Jm
Jm
Jm
ab
ab
ab
ab
ef
ef
ef
ef
ef
ef
ef
HZ
ab
ab
Jm
ab
ab
ab
ab
ab
ab
ab
ab
ef
ef
KO
ef
ef
ef
ef
ef
ef
ef
ef
ef
ef
ef
ef
ef
ef
ef
ef
ef
ef
"}
(28,1,1) = {"
ef
ef
ef
ef
ab
ab
ab
RN
ef
ef
RN
kO
Jm
Jm
kO
kO
Jm
ab
ab
Jm
ab
ab
ab
ab
ab
ef
ef
ef
ef
ef
ef
ef
ef
ef
ab
ab
ab
ab
ab
ab
ab
ab
ab
ab
ef
ef
ef
KO
ef
ef
ef
ef
ri
ab
ab
ab
ef
RN
RN
RN
ef
ef
ef
ef
ef
"}
(29,1,1) = {"
ef
ef
ef
RN
ab
Jm
ab
ef
ef
RN
kO
tW
Jm
Jm
kO
qt
RN
ef
ef
ab
ab
ab
ab
ab
rs
ef
ef
ef
ef
ef
ef
ef
ef
ef
ab
ab
ab
ab
ab
ab
ab
ab
ab
ab
ef
ef
ef
ef
ef
ef
ef
ef
ab
ab
ab
ab
ab
ab
Jm
Jm
RN
ef
ef
ef
ef
"}
(30,1,1) = {"
ef
ef
ef
RN
Jm
Jm
ab
ab
ef
RN
Jm
Jm
Jm
kO
RN
ef
ef
ef
ef
ef
ab
ab
ab
rs
rs
ef
ef
ef
ef
ef
ef
ef
ef
ab
ab
ab
ab
ef
ef
ef
ef
ab
ab
ef
ef
ef
ef
ef
ef
ef
ef
RN
ab
ab
ab
ab
ab
ab
ab
Jm
Jm
RN
ef
ef
ef
"}
(31,1,1) = {"
ef
ef
ef
ef
Jm
Jm
Jm
ab
ri
ab
ab
ab
Jm
HZ
ef
ef
ef
ef
ef
ef
ef
rs
rs
rs
rs
rs
ef
ef
ef
ef
ef
ef
ef
ab
ab
ab
RN
ef
ef
ef
RN
Jm
ab
ri
ef
RN
ef
ef
ef
ef
ef
ab
ab
ab
ef
ef
ef
ef
ab
ab
ri
ab
ef
ef
ef
"}
(32,1,1) = {"
ef
ef
ef
ef
RN
Jm
ab
ab
ab
ab
ab
ab
ab
ef
ef
ef
ef
ef
ef
ef
ef
rs
rs
rs
rs
rs
rs
ef
ef
ef
ef
ef
ef
ab
ab
ri
RN
ef
RN
ef
pq
ab
ab
ab
Jm
ab
ab
RN
ef
RN
ab
ab
ab
ef
ef
ef
ef
ef
ef
ab
ab
ab
ef
ef
ef
"}
(33,1,1) = {"
ef
ef
ef
ef
RN
HZ
ab
ab
ab
ab
ab
ab
ab
RN
ef
ef
ef
ef
ef
ef
ef
rs
rs
rs
rs
rs
rs
ef
ef
ef
ef
ef
rs
ab
ab
ab
ab
ab
ab
ab
ab
ab
ab
ab
ab
Jm
Jm
ab
RN
ab
ab
ab
ab
ef
ef
ef
ef
ef
ef
ef
ab
ab
ef
ef
ef
"}
(34,1,1) = {"
ef
ef
ef
ef
ef
RN
ef
ab
ab
ab
ab
ab
ri
RN
ef
ef
ef
ef
ef
ef
ef
ef
rs
rs
rs
ab
ab
FL
RN
RN
ef
ef
rs
rs
ab
ab
ab
ab
ab
ab
ab
ef
ef
RN
Jm
jS
Jm
ab
ab
ab
ab
ab
RN
ef
ef
ef
ef
ef
ef
ef
ab
ab
ab
ef
ef
"}
(35,1,1) = {"
ef
ef
ef
ef
ef
ef
ef
ef
ab
ab
ab
ab
ab
ab
RN
ef
ef
ef
ef
ef
ef
gp
oP
oP
Ak
Qr
ab
ab
ab
ab
ab
ab
rs
rs
ef
ef
RN
ab
ri
ab
ab
ef
ef
RN
Jm
kO
Jm
ab
ab
ab
ab
RN
ef
ef
ef
ef
ef
ef
ef
ef
ef
ab
ab
ef
ef
"}
(36,1,1) = {"
ef
ef
ef
ef
ef
ef
ef
RN
ab
ab
ab
ab
ab
ab
pq
ef
ef
ef
ef
ef
RD
YB
zJ
oP
ab
ab
up
ab
ab
oP
oP
oP
oP
ef
ef
ef
ef
RN
ab
ab
ef
ef
ef
HZ
Jm
Jm
ab
ab
ab
Jm
ab
RN
ef
ef
ef
ef
ef
ef
ef
ef
ef
ab
ab
RN
ef
"}
(37,1,1) = {"
ef
ef
ef
ef
ef
ef
RN
Jm
ab
Jm
ab
ab
ab
ab
ab
ef
ef
ef
ef
mA
Qs
Ay
Ay
FJ
ab
ab
YU
ab
lD
Tf
ab
Ay
YB
mA
ef
ef
ef
ef
ab
ab
ef
ef
ef
ef
ef
ef
ef
ef
RN
kO
Jm
ab
RN
ef
ef
ef
ef
ef
ef
ef
ab
ab
ab
RN
ef
"}
(38,1,1) = {"
ef
ef
ef
ef
ef
ef
kO
Jm
Jm
Jm
Jm
ab
ab
ab
ab
te
ef
ef
ef
mA
YB
Ay
ab
do
Ay
ab
bH
ab
Ay
oP
Ay
Ay
io
mA
ef
ef
ef
RN
ab
ab
HZ
RN
ef
ef
ef
ef
ef
ef
RN
jS
Jm
ab
HZ
RN
ef
ef
ef
ef
ef
RN
ab
ab
HZ
ef
ef
"}
(39,1,1) = {"
ef
ef
ef
ef
ef
ef
jS
Jm
Jm
Jm
ab
ab
ab
ab
ab
ab
ab
gM
ab
oP
oP
oP
oP
FJ
ab
ab
bH
ab
Ay
oP
Is
Ay
mA
ef
ef
ef
ef
ef
Jm
ab
ab
RN
ef
ef
ef
ef
ef
ef
ef
RN
Jm
Jm
ab
RN
ef
ef
ef
ef
HZ
ab
ab
ef
ef
ef
ef
"}
(40,1,1) = {"
ef
ef
ef
ef
ef
Jm
Jm
Jm
ab
ab
ef
RN
RN
ab
ab
ab
ab
gM
ab
rY
tB
UX
ab
VB
Xt
PO
KR
ab
ii
oP
ng
ZJ
mA
ef
ef
ef
ef
RN
ab
Jm
Jm
ab
RN
ef
ef
ef
ef
ef
ef
RN
ab
Yk
ab
RN
ef
ef
ef
ab
ab
ab
ab
ef
ef
ef
ef
"}
(41,1,1) = {"
ef
ef
ef
ef
ef
ab
Jm
ab
ab
ef
ef
ef
ef
ef
te
ab
ab
gM
ab
Ay
Ay
Ay
ab
bH
Ay
tG
ab
ab
mE
oP
oP
oP
gp
ef
ef
ef
ef
RN
qt
kO
Jm
Jm
ab
ab
ab
ef
ef
ef
RN
ab
ab
ab
ab
ab
ef
ef
ab
ab
ab
ab
ab
ab
RN
ef
ef
"}
(42,1,1) = {"
ef
ef
ef
ef
ef
ab
ab
ab
ab
ef
ef
ef
ef
ef
ef
JC
DL
ab
ab
Qr
ab
ab
ab
lc
Ay
Ay
Re
ab
ab
es
Ay
xd
gp
ef
ef
ef
ef
RN
Jm
kO
Jm
ab
ab
ab
ab
ab
ab
ab
ab
ab
ab
ab
ab
ab
ab
ab
ab
ab
ab
ab
ab
ab
ab
ef
ef
"}
(43,1,1) = {"
ef
ef
ef
ef
ef
ab
ab
ab
ef
ef
ef
ef
ef
ef
ef
ef
ab
ab
Qr
Xt
bO
Xt
Xt
KR
ab
ab
ab
ab
ab
ab
BG
ab
ef
RN
ef
ef
ef
HZ
ab
Jm
ab
ab
ab
ab
ab
ab
ab
ab
ab
ab
ab
ab
ri
ab
ab
ab
ab
ab
HZ
ef
ef
ab
ab
ef
ef
"}
(44,1,1) = {"
ef
ef
ef
ef
HZ
ab
ab
ab
RN
ef
ef
ef
ef
ef
ef
HZ
ab
ab
ab
ab
RN
ef
ef
ab
ab
ab
ab
ab
ab
ab
ab
ab
ab
ri
RN
ef
ef
rs
ab
ab
ef
ef
ab
ab
ab
ab
ab
ef
ef
RN
RN
ef
ab
ab
ab
ab
ab
ab
gp
gp
gp
LU
ab
te
ef
"}
(45,1,1) = {"
ef
ef
ef
ef
ab
ab
ab
ab
RN
ef
ef
ef
ef
ef
RN
ab
ab
ab
ab
HZ
RN
ef
ef
RD
ab
ab
ab
ab
ab
ab
pu
ab
ab
ab
ab
ab
rs
rs
rs
ef
ef
ef
ef
ef
ef
ef
ef
ef
ef
ef
ef
ef
ef
ef
te
pZ
ab
ab
sT
Mu
eo
If
Ay
yv
ef
"}
(46,1,1) = {"
ef
ef
ef
ef
ab
ri
ab
ab
ef
ef
ef
ef
ef
ef
ef
ab
ab
Jm
qt
ef
ef
ef
ef
ef
ab
ab
ab
ab
Yk
ab
RN
ef
ab
ab
ab
ab
rs
rs
ef
ef
ef
ef
ef
ef
ef
ef
ef
ef
ef
ef
ef
ef
ef
ef
gp
SY
Ay
ab
Yk
ab
Qr
ab
Ay
Rn
ef
"}
(47,1,1) = {"
ef
ef
ef
ef
ab
ab
ab
ab
ab
RN
ef
ef
ef
ef
ef
ab
Jm
kO
ef
ef
ef
ef
ef
RN
ab
ab
ab
ab
Jm
RN
ef
ef
ef
ab
ab
ab
ab
rs
ef
ef
ef
ef
ef
ef
ef
ef
ef
ef
ef
ef
ef
ef
ef
ef
gp
KM
ab
ab
ab
ab
ab
ab
ab
ds
ef
"}
(48,1,1) = {"
ef
ef
ef
ef
ef
ab
ab
ab
uZ
ab
ab
ef
RN
RN
ef
ab
ab
Jm
RN
ef
ef
ef
ef
RN
ab
ab
ab
qt
kO
ef
ef
ef
ef
ab
ab
ab
Qr
RN
ef
ef
ef
ef
ef
ef
ef
ef
ef
ef
ef
ef
ef
ef
ef
ef
ef
oP
oP
oP
oP
do
oP
ab
ab
Zf
ef
"}
(49,1,1) = {"
ef
ef
ef
ef
ef
ab
ab
ab
ab
ab
ab
ab
ab
ab
ab
ab
ab
Jm
RN
ef
ef
ef
ef
ri
ab
ab
ab
Jm
RN
ef
ef
ef
ef
ef
Ng
ab
Ng
ef
ef
ef
ef
ef
ef
ef
ef
ef
ef
ef
ef
ef
ef
ef
ef
ef
ef
RD
Qy
lD
Ay
ab
oP
ab
ab
Mo
ef
"}
(50,1,1) = {"
ef
ef
ef
ef
ef
ef
ab
ab
ab
ab
ab
Jm
Jm
ab
ab
ab
ab
ab
RN
ef
ef
ef
te
ab
ab
ab
ab
HZ
RN
ef
ef
ef
ef
RN
ab
ab
ab
ab
ef
ef
ef
ef
ef
ef
ef
ef
ef
ef
ef
ef
ef
ef
ef
ef
ef
mA
LR
Ay
Ay
ab
oP
ab
ri
ef
ef
"}
(51,1,1) = {"
ef
ef
ef
ef
ef
ef
ef
ef
ef
ab
Ro
kO
Jm
Jm
ab
ab
ab
ab
ab
ef
ef
ab
DL
ab
ab
ab
te
ef
ef
ef
ef
ef
ef
RN
ab
ab
Qr
ab
RN
ef
ef
ef
ef
ef
ef
ef
ef
ef
ef
ef
ef
ef
ef
ef
ef
mA
Ay
Ay
Ay
YB
oP
ab
ef
ef
ef
"}
(52,1,1) = {"
ef
ef
ef
ef
ef
ef
ef
ef
ef
RN
RN
kO
qt
kO
Jm
ab
ab
ab
ri
ab
ab
ab
ab
ab
ab
ef
ef
ef
ef
ef
ef
ef
ef
ef
HZ
Qr
Qr
Jm
RN
ef
ef
ef
ef
ef
ef
Jm
Jm
Jm
ef
ef
ef
ef
ef
ef
ef
mA
YB
pF
gp
gp
ef
ef
ef
ef
ef
"}
(53,1,1) = {"
ef
ef
ef
ef
ef
ef
ef
ef
ef
ef
ef
ef
ef
RN
RN
ab
ab
ab
ab
ab
ab
Jm
ab
Jm
RN
ef
ef
ef
ef
ef
ef
ef
ef
ef
ef
ab
jg
Jm
ef
RN
ab
ab
Jm
Jm
Jm
Jm
Jm
Ro
Jm
Jm
ab
ri
RN
ef
ef
ef
gp
gp
ef
ef
ef
ef
ef
ef
ef
"}
(54,1,1) = {"
ef
ef
ef
ef
ef
ef
ef
ef
ef
ef
ef
ef
ef
ef
ef
ab
ab
ab
ab
ab
Jm
Jm
Jm
Jm
RN
ef
ef
ef
ef
ef
ef
ef
RN
RN
ef
Jm
Jm
Jm
Jm
ab
Jm
Jm
vM
vM
Jm
Jm
tW
tW
Jm
Jm
Jm
Ri
BD
RN
ef
ef
ef
ef
ef
ef
ef
ef
ef
ef
ef
"}
(55,1,1) = {"
ef
ef
ef
ef
ef
ef
ef
ef
ef
ef
ef
ef
ef
ef
ef
ef
RN
ab
ab
ab
ab
Jm
RN
RN
ef
ef
ef
ef
ef
RN
RN
BD
ab
ab
ab
Jm
Jm
Jm
Jm
Jm
sf
Jm
vM
Ro
tW
kO
kO
tW
tW
Jm
Jm
ab
ab
HZ
ef
ef
ef
ef
ef
ef
ef
ef
ef
ef
ef
"}
(56,1,1) = {"
ef
ef
ef
ef
ef
ef
ef
ef
ef
ef
ef
ef
ef
ef
ef
ef
ef
RN
ab
ab
ab
ef
ef
ef
ef
ef
ef
ef
RN
HZ
ab
ab
ab
Jm
Jm
Jm
Jm
Jm
Jm
Jm
Jm
Jm
Jm
tW
Au
kO
kO
kO
Ro
Jm
Jm
Jm
ab
ab
ef
ef
ef
ef
ef
ef
ef
ef
ef
ef
ef
"}
(57,1,1) = {"
ef
ef
ef
ef
ef
ef
ef
ef
ef
ef
ef
ef
ef
ef
ef
ef
ef
ef
ef
ab
ab
ab
ef
ef
ef
ef
ef
ef
ef
ab
ab
Jm
ab
ab
Jm
Jm
Qr
Jm
Qr
ab
ab
Jm
ab
tW
CH
kO
kO
Th
tW
tW
Jm
Jm
ab
ab
RN
ef
ef
ef
ef
ef
ef
ef
ef
ef
ef
"}
(58,1,1) = {"
ef
ef
ef
ef
ef
ef
ef
ef
ef
ef
ef
ef
ef
ef
ef
ef
ef
ef
ef
ef
ab
ab
ab
ef
ef
ef
ef
ef
ab
ab
Jm
ab
ab
ab
Jm
Jm
ab
jg
Jm
Jm
Jm
Jm
Jm
Jm
kO
kO
kO
kO
kO
kO
tW
Jm
Jm
ri
RN
ef
ef
ef
ef
ef
ef
ef
ef
ef
ef
"}
(59,1,1) = {"
ef
ef
ef
ef
ef
ef
ef
ef
ef
ef
ef
ef
ef
ef
ef
ef
ef
ef
ef
ef
ef
ab
ab
ab
ab
pJ
ab
ab
ab
ab
ab
ab
ab
Jm
Jm
ab
ri
ab
Jm
Jm
Jm
vn
tW
Au
kO
kO
RJ
kO
kO
EY
tW
Jm
Jm
ab
ef
ef
ef
ef
ef
ef
ef
ef
ef
ef
ef
"}
(60,1,1) = {"
ef
ef
ef
ef
ef
ef
ef
ef
ef
ef
ef
ef
ef
ef
ef
ef
ef
ef
ef
ef
ef
ef
ef
ab
ab
ab
ab
ab
ab
ab
ab
ab
ab
Jm
ab
Jm
ab
ab
ef
Jm
Jm
ri
Jm
tW
kO
Lf
kO
kO
kO
kO
tW
Jm
Jm
ab
ef
ef
ef
ef
ef
ef
ef
ef
ef
ef
ef
"}
(61,1,1) = {"
ef
ef
ef
ef
ef
ef
ef
ef
ef
ef
ef
ef
ef
ef
ef
ef
ef
ef
ef
ef
ef
ef
ef
ef
ef
ef
ef
ab
ab
ab
ab
ef
ef
ef
ef
RN
RN
ef
ef
ef
Jm
ab
Jm
Ro
kO
CH
kO
kO
kO
Au
Jm
Jm
Jm
ab
RN
ef
ef
ef
ef
ef
ef
ef
ef
ef
ef
"}
(62,1,1) = {"
ef
ef
ef
ef
ef
ef
ef
ef
ef
ef
ef
ef
ef
ef
ef
ef
ef
ef
ef
ef
ef
ef
ef
ef
ef
ef
ef
ef
ef
ef
ef
ef
ef
ef
ef
ef
ef
ef
ef
ef
ef
ab
vn
xp
tW
kO
kO
kO
tW
Jm
Jm
Jm
Jm
ab
RN
ef
ef
ef
ef
ef
ef
ef
ef
ef
ef
"}
(63,1,1) = {"
ef
ef
ef
ef
ef
ef
ef
ef
ef
ef
ef
ef
ef
ef
ef
ef
ef
ef
ef
ef
ef
ef
ef
ef
ef
ef
ef
ef
ef
ef
ef
ef
ef
ef
ef
ef
ef
ef
ef
ef
ef
HZ
ab
ab
tW
tW
pN
vn
Jm
Jm
Jm
ab
Jm
ab
RN
ef
ef
ef
ef
ef
ef
ef
ef
ef
ef
"}
(64,1,1) = {"
ef
ef
ef
ef
ef
ef
ef
ef
ef
ef
ef
ef
ef
ef
ef
ef
ef
ef
ef
ef
ef
ef
ef
ef
ef
ef
ef
ef
ef
ef
ef
ef
ef
ef
ef
ef
ef
ef
ef
ef
ef
RN
Jm
Jm
Jm
Jm
Au
Jm
Ro
Jm
Jm
ab
Jm
ab
ef
ef
ef
ef
ef
ef
ef
ef
ef
ef
ef
"}
(65,1,1) = {"
ef
ef
ef
ef
ef
ef
ef
ef
ef
ef
ef
ef
ef
ef
ef
ef
ef
ef
ef
ef
ef
ef
ef
ef
ef
ef
ef
ef
ef
ef
ef
ef
ef
ef
ef
ef
ef
ef
ef
ef
ef
ef
BD
ab
Jm
Jm
Jm
Jm
Jm
Jm
Ro
vn
ab
ef
ef
ef
ef
ef
ef
ef
ef
ef
ef
ef
ef
"}
(66,1,1) = {"
ef
ef
ef
ef
ef
ef
ef
ef
ef
ef
ef
ef
ef
ef
ef
ef
ef
ef
ef
ef
ef
ef
ef
ef
ef
ef
ef
ef
ef
ef
ef
ef
ef
ef
ef
ef
ef
ef
ef
ef
ef
ef
RN
ab
ri
Jm
ab
Jm
Jm
ab
Jm
ab
ab
ef
ef
ef
ef
ef
ef
ef
ef
ef
ef
ef
ef
"}
(67,1,1) = {"
ef
ef
ef
ef
ef
ef
ef
ef
ef
ef
ef
ef
ef
ef
ef
ef
ef
ef
ef
ef
ef
ef
ef
ef
ef
ef
ef
ef
ef
ef
ef
ef
ef
ef
ef
ef
ef
ef
ef
ef
ef
ef
ef
RN
ab
Ri
ab
HZ
ab
ab
ab
BD
RN
ef
ef
ef
ef
ef
ef
ef
ef
ef
ef
ef
ef
"}
(68,1,1) = {"
ef
ef
ef
ef
ef
ef
ef
ef
ef
ef
ef
ef
ef
ef
ef
ef
ef
ef
ef
ef
ef
ef
ef
ef
ef
ef
ef
ef
ef
ef
ef
ef
ef
ef
ef
ef
ef
ef
ef
ef
ef
ef
ef
ef
ef
ef
RN
RN
RN
RN
ef
ef
ef
ef
ef
ef
ef
ef
ef
ef
ef
ef
ef
ef
ef
"}
